"","id","name_long","bev_total","bev_male","bev_female"
"1","08","Baden-Württemberg, Land",11069533,5501693,5567840
"2","081","Stuttgart, Regierungsbezirk",4143418,2067094,2076324
"3","08111000","Stuttgart, Landeshauptstadt, Stadtkreis",634830,317139,317691
"4","08115","Böblingen, Landkreis",391640,194989,196651
"5","08115001","Aidlingen",9024,4440,4584
"6","08115002","Altdorf",4662,2314,2348
"7","08115003","Böblingen, Stadt",50155,24746,25409
"8","08115004","Bondorf",6002,3028,2974
"9","08115010","Deckenpfronn",3329,1663,1666
"10","08115013","Ehningen",9193,4572,4621
"11","08115015","Gärtringen",12417,6155,6262
"12","08115016","Gäufelden",9350,4726,4624
"13","08115021","Herrenberg, Stadt",31545,15445,16100
"14","08115022","Hildrizhausen",3606,1816,1790
"15","08115024","Holzgerlingen, Stadt",13103,6454,6649
"16","08115028","Leonberg, Stadt",48733,24361,24372
"17","08115029","Magstadt",9659,4944,4715
"18","08115034","Mötzingen",3683,1821,1862
"19","08115037","Nufringen",5872,2999,2873
"20","08115041","Renningen, Stadt",18206,9100,9106
"21","08115042","Rutesheim, Stadt",10916,5426,5490
"22","08115044","Schönaich",10652,5317,5335
"23","08115045","Sindelfingen, Stadt",64858,32305,32553
"24","08115046","Steinenbronn",6554,3415,3139
"25","08115048","Waldenbuch, Stadt",8717,4289,4428
"26","08115050","Weil der Stadt, Stadt",19205,9640,9565
"27","08115051","Weil im Schönbuch",10018,4958,5060
"28","08115052","Weissach",7519,3731,3788
"29","08115053","Jettingen",7915,3905,4010
"30","08115054","Grafenau",6747,3419,3328
"31","08116","Esslingen, Landkreis",533859,266783,267076
"32","08116004","Altbach",5967,2999,2968
"33","08116005","Altdorf",1700,861,839
"34","08116006","Altenriet",1921,955,966
"35","08116007","Baltmannsweiler",5756,2835,2921
"36","08116008","Bempflingen",3485,1751,1734
"37","08116011","Beuren",3655,1828,1827
"38","08116012","Bissingen an der Teck",3441,1788,1653
"39","08116014","Deizisau",6944,3614,3330
"40","08116015","Denkendorf",11240,5765,5475
"41","08116016","Dettingen unter Teck",6142,3124,3018
"42","08116018","Erkenbrechtsweiler",2200,1117,1083
"43","08116019","Esslingen am Neckar, Stadt",93542,46746,46796
"44","08116020","Frickenhausen",9150,4594,4556
"45","08116022","Großbettlingen",4449,2220,2229
"46","08116027","Hochdorf",4749,2358,2391
"47","08116029","Holzmaden",2319,1169,1150
"48","08116033","Kirchheim unter Teck, Stadt",40523,19948,20575
"49","08116035","Köngen",9975,4979,4996
"50","08116036","Kohlberg",2324,1159,1165
"51","08116037","Lichtenwald",2694,1319,1375
"52","08116041","Neckartailfingen",3846,1951,1895
"53","08116042","Neckartenzlingen",6498,3264,3234
"54","08116043","Neidlingen",1836,914,922
"55","08116046","Neuffen, Stadt",6299,3200,3099
"56","08116047","Neuhausen auf den Fildern",11893,5932,5961
"57","08116048","Notzingen",3687,1890,1797
"58","08116049","Nürtingen, Stadt",41093,20618,20475
"59","08116050","Oberboihingen",5522,2775,2747
"60","08116053","Ohmden",1721,870,851
"61","08116054","Owen, Stadt",3392,1712,1680
"62","08116056","Plochingen, Stadt",14433,7187,7246
"63","08116058","Reichenbach an der Fils",8431,4228,4203
"64","08116063","Schlaitdorf",1931,949,982
"65","08116068","Unterensingen",4895,2488,2407
"66","08116070","Weilheim an der Teck, Stadt",10275,5185,5090
"67","08116071","Wendlingen am Neckar, Stadt",16268,8085,8183
"68","08116072","Wernau (Neckar), Stadt",12324,6117,6207
"69","08116073","Wolfschlugen",6339,3135,3204
"70","08116076","Aichwald",7559,3696,3863
"71","08116077","Filderstadt, Stadt",45813,22878,22935
"72","08116078","Leinfelden-Echterdingen, Stadt",40092,19903,20189
"73","08116079","Lenningen",8314,4213,4101
"74","08116080","Ostfildern, Stadt",39321,19468,19853
"75","08116081","Aichtal, Stadt",9901,4996,4905
"76","08117","Göppingen, Landkreis",257253,128093,129160
"77","08117001","Adelberg",1997,991,1006
"78","08117002","Aichelberg",1342,697,645
"79","08117003","Albershausen",4385,2179,2206
"80","08117006","Bad Ditzenbach",3741,1870,1871
"81","08117007","Bad Überkingen",3846,1912,1934
"82","08117009","Birenbach",1920,943,977
"83","08117010","Böhmenkirch",5527,2855,2672
"84","08117011","Börtlingen",1688,836,852
"85","08117012","Bad Boll",5197,2503,2694
"86","08117014","Deggingen",5331,2633,2698
"87","08117015","Donzdorf, Stadt",10682,5390,5292
"88","08117016","Drackenstein",439,216,223
"89","08117017","Dürnau",2169,1075,1094
"90","08117018","Ebersbach an der Fils, Stadt",15535,7750,7785
"91","08117019","Eislingen/Fils, Stadt",20885,10327,10558
"92","08117020","Eschenbach",2142,1050,1092
"93","08117023","Gammelshausen",1400,705,695
"94","08117024","Geislingen an der Steige, Stadt",28122,14118,14004
"95","08117025","Gingen an der Fils",4501,2221,2280
"96","08117026","Göppingen, Stadt",57558,28502,29056
"97","08117028","Gruibingen",2272,1224,1048
"98","08117029","Hattenhofen",2989,1509,1480
"99","08117030","Heiningen",5139,2543,2596
"100","08117031","Hohenstadt",759,400,359
"101","08117033","Kuchen",5658,2823,2835
"102","08117035","Mühlhausen im Täle",1057,528,529
"103","08117037","Ottenbach",2417,1214,1203
"104","08117038","Rechberghausen",5426,2622,2804
"105","08117042","Salach",7983,3975,4008
"106","08117043","Schlat",1697,856,841
"107","08117044","Schlierbach",3972,1994,1978
"108","08117049","Süßen, Stadt",10192,5127,5065
"109","08117051","Uhingen, Stadt",14422,7147,7275
"110","08117053","Wäschenbeuren",3918,1891,2027
"111","08117055","Wangen",3191,1603,1588
"112","08117058","Wiesensteig, Stadt",2065,1036,1029
"113","08117060","Zell unter Aichelberg",3137,1579,1558
"114","08117061","Lauterstein, Stadt",2552,1249,1303
"115","08118","Ludwigsburg, Landkreis",543984,269961,274023
"116","08118001","Affalterbach",4518,2246,2272
"117","08118003","Asperg, Stadt",13480,6697,6783
"118","08118006","Benningen am Neckar",6477,3242,3235
"119","08118007","Besigheim, Stadt",12627,6328,6299
"120","08118010","Bönnigheim, Stadt",8015,3972,4043
"121","08118011","Ditzingen, Stadt",24883,12398,12485
"122","08118012","Eberdingen",6824,3436,3388
"123","08118014","Erdmannhausen",5145,2602,2543
"124","08118015","Erligheim",2913,1478,1435
"125","08118016","Freudental",2486,1226,1260
"126","08118018","Gemmrigheim",4351,2215,2136
"127","08118019","Gerlingen, Stadt",19745,9665,10080
"128","08118021","Großbottwar, Stadt",8512,4295,4217
"129","08118027","Hemmingen",8086,4050,4036
"130","08118028","Hessigheim",2458,1219,1239
"131","08118040","Kirchheim am Neckar",5904,2939,2965
"132","08118046","Kornwestheim, Stadt",33803,16747,17056
"133","08118047","Löchgau",5608,2770,2838
"134","08118048","Ludwigsburg, Stadt",93499,46058,47441
"135","08118049","Marbach am Neckar, Stadt",16008,7901,8107
"136","08118050","Markgröningen, Stadt",14785,7469,7316
"137","08118051","Möglingen",11361,5598,5763
"138","08118053","Mundelsheim",3336,1697,1639
"139","08118054","Murr",6553,3220,3333
"140","08118059","Oberriexingen, Stadt",3319,1677,1642
"141","08118060","Oberstenfeld",8027,3970,4057
"142","08118063","Pleidelsheim",6343,3160,3183
"143","08118067","Schwieberdingen",11383,5729,5654
"144","08118068","Sersheim",5568,2762,2806
"145","08118070","Steinheim an der Murr, Stadt",12220,6040,6180
"146","08118071","Tamm",12685,6326,6359
"147","08118073","Vaihingen an der Enz, Stadt",29467,14725,14742
"148","08118074","Walheim",3264,1638,1626
"149","08118076","Sachsenheim, Stadt",18794,9369,9425
"150","08118077","Ingersheim",6330,3139,3191
"151","08118078","Freiberg am Neckar, Stadt",15968,7792,8176
"152","08118079","Bietigheim-Bissingen, Stadt",43093,21179,21914
"153","08118080","Korntal-Münchingen, Stadt",19679,9818,9861
"154","08118081","Remseck am Neckar, Stadt",26467,13169,13298
"155","08119","Rems-Murr-Kreis, Landkreis",426158,210861,215297
"156","08119001","Alfdorf",7085,3584,3501
"157","08119003","Allmersbach im Tal",4840,2424,2416
"158","08119004","Althütte",4206,2133,2073
"159","08119006","Auenwald",6779,3383,3396
"160","08119008","Backnang, Stadt",37253,18546,18707
"161","08119018","Burgstetten",3685,1867,1818
"162","08119020","Fellbach, Stadt",45671,22144,23527
"163","08119024","Großerlach",2437,1313,1124
"164","08119037","Kaisersbach",2476,1260,1216
"165","08119038","Kirchberg an der Murr",3880,1940,1940
"166","08119041","Korb",10759,5259,5500
"167","08119042","Leutenbach",11517,5693,5824
"168","08119044","Murrhardt, Stadt",14033,6934,7099
"169","08119053","Oppenweiler",4281,2196,2085
"170","08119055","Plüderhausen",9487,4689,4798
"171","08119061","Rudersberg",11382,5698,5684
"172","08119067","Schorndorf, Stadt",39634,19449,20185
"173","08119068","Schwaikheim",9481,4679,4802
"174","08119069","Spiegelberg",2111,1095,1016
"175","08119075","Sulzbach an der Murr",5340,2669,2671
"176","08119076","Urbach",8863,4450,4413
"177","08119079","Waiblingen, Stadt",55449,27334,28115
"178","08119083","Weissach im Tal",7354,3649,3705
"179","08119084","Welzheim, Stadt",11176,5474,5702
"180","08119085","Winnenden, Stadt",28339,14010,14329
"181","08119086","Winterbach",7660,3726,3934
"182","08119087","Aspach",8187,4126,4061
"183","08119089","Berglen",6387,3202,3185
"184","08119090","Remshalden",14042,7006,7036
"185","08119091","Weinstadt, Stadt",26987,13284,13703
"186","08119093","Kernen im Remstal",15377,7645,7732
"187","08121000","Heilbronn, Stadtkreis",125960,63527,62433
"188","08125","Heilbronn, Landkreis",343068,172382,170686
"189","08125001","Abstatt",4803,2443,2360
"190","08125005","Bad Friedrichshall, Stadt",19264,9731,9533
"191","08125006","Bad Rappenau, Stadt",21398,10558,10840
"192","08125007","Bad Wimpfen, Stadt",7359,3762,3597
"193","08125008","Beilstein, Stadt",6195,3102,3093
"194","08125013","Brackenheim, Stadt",16106,8075,8031
"195","08125017","Cleebronn",2983,1534,1449
"196","08125021","Eberstadt",3103,1542,1561
"197","08125024","Ellhofen",3724,1880,1844
"198","08125026","Eppingen, Stadt",21819,10932,10887
"199","08125027","Erlenbach",5121,2520,2601
"200","08125030","Flein",7041,3356,3685
"201","08125034","Gemmingen",5145,2561,2584
"202","08125038","Güglingen, Stadt",6353,3250,3103
"203","08125039","Gundelsheim, Stadt",7254,3667,3587
"204","08125046","Ilsfeld",9568,4933,4635
"205","08125047","Ittlingen",2571,1303,1268
"206","08125048","Jagsthausen",1880,889,991
"207","08125049","Kirchardt",5921,3037,2884
"208","08125056","Lauffen am Neckar, Stadt",11640,5820,5820
"209","08125057","Lehrensteinsfeld",2479,1245,1234
"210","08125058","Leingarten",11633,5811,5822
"211","08125059","Löwenstein, Stadt",3394,1705,1689
"212","08125061","Massenbachhausen",3499,1784,1715
"213","08125063","Möckmühl, Stadt",8078,4137,3941
"214","08125065","Neckarsulm, Stadt",26492,13223,13269
"215","08125066","Neckarwestheim",3961,2023,1938
"216","08125068","Neudenau, Stadt",5266,2646,2620
"217","08125069","Neuenstadt am Kocher, Stadt",10123,5088,5035
"218","08125074","Nordheim",8270,4123,4147
"219","08125078","Oedheim",6455,3212,3243
"220","08125079","Offenau",2911,1466,1445
"221","08125081","Pfaffenhofen",2424,1237,1187
"222","08125084","Roigheim",1442,768,674
"223","08125086","Schwaigern, Stadt",11425,5847,5578
"224","08125087","Siegelsbach",1626,821,805
"225","08125094","Talheim",4962,2517,2445
"226","08125096","Untereisesheim",4173,2081,2092
"227","08125098","Untergruppenbach",8304,4133,4171
"228","08125102","Weinsberg, Stadt",12336,6208,6128
"229","08125103","Widdern, Stadt",1809,947,862
"230","08125107","Wüstenrot",6750,3245,3505
"231","08125108","Zaberfeld",4087,2045,2042
"232","08125110","Obersulm",13914,6954,6960
"233","08125111","Hardthausen am Kocher",4159,2217,1942
"234","08125113","Langenbrettach",3848,2004,1844
"235","08126","Hohenlohekreis, Landkreis",112010,56550,55460
"236","08126011","Bretzfeld",12651,6363,6288
"237","08126020","Dörzbach",2485,1239,1246
"238","08126028","Forchtenberg, Stadt",5057,2614,2443
"239","08126039","Ingelfingen, Stadt",5480,2729,2751
"240","08126045","Krautheim, Stadt",4613,2434,2179
"241","08126046","Künzelsau, Stadt",15391,7749,7642
"242","08126047","Kupferzell",6164,3158,3006
"243","08126056","Mulfingen",3643,1891,1752
"244","08126058","Neuenstein, Stadt",6531,3304,3227
"245","08126060","Niedernhall, Stadt",4106,2052,2054
"246","08126066","Öhringen, Stadt",24374,12071,12303
"247","08126069","Pfedelbach",9123,4583,4540
"248","08126072","Schöntal",5610,2873,2737
"249","08126085","Waldenburg, Stadt",3094,1609,1485
"250","08126086","Weißbach",2021,999,1022
"251","08126094","Zweiflingen",1667,882,785
"252","08127","Schwäbisch Hall, Landkreis",195861,98314,97547
"253","08127008","Blaufelden",5283,2744,2539
"254","08127009","Braunsbach",2506,1268,1238
"255","08127012","Bühlertann",3027,1527,1500
"256","08127013","Bühlerzell",2026,1026,1000
"257","08127014","Crailsheim, Stadt",34400,17376,17024
"258","08127023","Fichtenberg",2922,1466,1456
"259","08127025","Gaildorf, Stadt",12080,5932,6148
"260","08127032","Gerabronn, Stadt",4270,2153,2117
"261","08127043","Ilshofen, Stadt",6584,3358,3226
"262","08127046","Kirchberg an der Jagst, Stadt",4393,2346,2047
"263","08127047","Langenburg, Stadt",1831,947,884
"264","08127052","Mainhardt",6017,2981,3036
"265","08127056","Michelbach an der Bilz",3389,1676,1713
"266","08127059","Michelfeld",3799,1918,1881
"267","08127062","Oberrot",3595,1811,1784
"268","08127063","Obersontheim",5079,2596,2483
"269","08127071","Rot am See",5388,2732,2656
"270","08127073","Satteldorf",5564,2842,2722
"271","08127075","Schrozberg, Stadt",5741,2972,2769
"272","08127076","Schwäbisch Hall, Stadt",40440,19636,20804
"273","08127079","Sulzbach-Laufen",2502,1266,1236
"274","08127086","Untermünkheim",3007,1504,1503
"275","08127089","Vellberg, Stadt",4446,2214,2232
"276","08127091","Wallhausen",3716,1886,1830
"277","08127099","Wolpertshausen",2249,1169,1080
"278","08127100","Rosengarten",5060,2481,2579
"279","08127101","Kreßberg",3968,2022,1946
"280","08127102","Fichtenau",4591,2329,2262
"281","08127103","Frankenhardt",4843,2473,2370
"282","08127104","Stimpfach",3145,1663,1482
"283","08128","Main-Tauber-Kreis, Landkreis",132321,65923,66398
"284","08128006","Assamstadt",2262,1128,1134
"285","08128007","Bad Mergentheim, Stadt",23704,11563,12141
"286","08128014","Boxberg, Stadt",6664,3399,3265
"287","08128020","Creglingen, Stadt",4694,2391,2303
"288","08128039","Freudenberg, Stadt",3774,1889,1885
"289","08128045","Großrinderfeld",3985,2020,1965
"290","08128047","Grünsfeld, Stadt",3651,1851,1800
"291","08128058","Igersheim",5552,2736,2816
"292","08128061","Königheim",2997,1517,1480
"293","08128064","Külsheim, Stadt",5122,2632,2490
"294","08128082","Niederstetten, Stadt",4834,2458,2376
"295","08128115","Tauberbischofsheim, Stadt",13231,6546,6685
"296","08128126","Weikersheim, Stadt",7333,3634,3699
"297","08128128","Werbach",3320,1654,1666
"298","08128131","Wertheim, Stadt",22780,11258,11522
"299","08128137","Wittighausen",1632,842,790
"300","08128138","Ahorn",2244,1168,1076
"301","08128139","Lauda-Königshofen, Stadt",14542,7237,7305
"302","08135","Heidenheim, Landkreis",132472,66092,66380
"303","08135010","Dischingen",4337,2235,2102
"304","08135015","Gerstetten",11599,5743,5856
"305","08135016","Giengen an der Brenz, Stadt",19666,9813,9853
"306","08135019","Heidenheim an der Brenz, Stadt",49526,24766,24760
"307","08135020","Herbrechtingen, Stadt",13051,6414,6637
"308","08135021","Hermaringen",2173,1137,1036
"309","08135025","Königsbronn",7134,3536,3598
"310","08135026","Nattheim",6162,3078,3084
"311","08135027","Niederstotzingen, Stadt",4693,2360,2333
"312","08135031","Sontheim an der Brenz",5508,2760,2748
"313","08135032","Steinheim am Albuch",8623,4250,4373
"314","08136","Ostalbkreis, Landkreis",314002,156480,157522
"315","08136002","Abtsgmünd",7417,3714,3703
"316","08136003","Adelmannsfelden",1688,857,831
"317","08136007","Bartholomä",2030,1004,1026
"318","08136009","Böbingen an der Rems",4565,2293,2272
"319","08136010","Bopfingen, Stadt",11727,5801,5926
"320","08136015","Durlangen",2856,1484,1372
"321","08136018","Ellenberg",1734,866,868
"322","08136019","Ellwangen (Jagst), Stadt",24549,12380,12169
"323","08136020","Eschach",1770,872,898
"324","08136021","Essingen",6352,3157,3195
"325","08136024","Göggingen",2479,1219,1260
"326","08136027","Gschwend",4888,2441,2447
"327","08136028","Heubach, Stadt",9774,4878,4896
"328","08136029","Heuchlingen",1858,948,910
"329","08136033","Hüttlingen",6099,3006,3093
"330","08136034","Iggingen",2589,1297,1292
"331","08136035","Jagstzell",2319,1182,1137
"332","08136037","Kirchheim am Ries",1820,931,889
"333","08136038","Lauchheim, Stadt",4780,2426,2354
"334","08136040","Leinzell",2041,1032,1009
"335","08136042","Lorch, Stadt",10885,5519,5366
"336","08136043","Mögglingen",4265,2120,2145
"337","08136044","Mutlangen",6664,3263,3401
"338","08136045","Neresheim, Stadt",7945,4092,3853
"339","08136046","Neuler",3177,1596,1581
"340","08136049","Obergröningen",447,233,214
"341","08136050","Oberkochen, Stadt",7895,3927,3968
"342","08136060","Rosenberg",2644,1360,1284
"343","08136061","Ruppertshofen",1845,955,890
"344","08136062","Schechingen",2268,1124,1144
"345","08136065","Schwäbisch Gmünd, Stadt",61186,29914,31272
"346","08136066","Spraitbach",3328,1644,1684
"347","08136068","Stödtlen",1889,935,954
"348","08136070","Täferrot",1005,508,497
"349","08136071","Tannhausen",1808,890,918
"350","08136075","Unterschneidheim",4740,2469,2271
"351","08136079","Waldstetten",7100,3478,3622
"352","08136082","Westhausen",6025,3037,2988
"353","08136084","Wört",1463,764,699
"354","08136087","Riesbürg",2314,1171,1143
"355","08136088","Aalen, Stadt",68456,33978,34478
"356","08136089","Rainau",3318,1715,1603
"357","082","Karlsruhe, Regierungsbezirk",2805129,1394621,1410508
"358","08211000","Baden-Baden, Stadtkreis",55123,26442,28681
"359","08212000","Karlsruhe, Stadtkreis",313092,160429,152663
"360","08215","Karlsruhe, Landkreis",444232,221339,222893
"361","08215007","Bretten, Stadt",29412,14648,14764
"362","08215009","Bruchsal, Stadt",44644,22430,22214
"363","08215017","Ettlingen, Stadt",39339,19186,20153
"364","08215021","Forst",8048,4032,4016
"365","08215025","Gondelsheim",3945,1987,1958
"366","08215029","Hambrücken",5527,2758,2769
"367","08215039","Kronau",5835,2904,2931
"368","08215040","Kürnbach",2335,1186,1149
"369","08215046","Malsch",14482,7367,7115
"370","08215047","Marxzell",4979,2503,2476
"371","08215059","Oberderdingen",10948,5397,5551
"372","08215064","Östringen, Stadt",13015,6645,6370
"373","08215066","Philippsburg, Stadt",13615,6975,6640
"374","08215082","Sulzfeld",4806,2424,2382
"375","08215084","Ubstadt-Weiher",13033,6508,6525
"376","08215089","Walzbachtal",9739,4833,4906
"377","08215090","Weingarten (Baden)",10482,5191,5291
"378","08215094","Zaisenhausen",1753,895,858
"379","08215096","Karlsbad",15771,7693,8078
"380","08215097","Kraichtal, Stadt",14627,7326,7301
"381","08215099","Graben-Neudorf",12184,6070,6114
"382","08215100","Bad Schönborn",13064,6595,6469
"383","08215101","Pfinztal",18407,9154,9253
"384","08215102","Eggenstein-Leopoldshafen",16625,8304,8321
"385","08215103","Karlsdorf-Neuthard",10705,5448,5257
"386","08215105","Linkenheim-Hochstetten",11796,5782,6014
"387","08215106","Waghäusel, Stadt",20935,10400,10535
"388","08215107","Oberhausen-Rheinhausen",9593,4804,4789
"389","08215108","Rheinstetten, Stadt",20340,9933,10407
"390","08215109","Stutensee, Stadt",24541,12128,12413
"391","08215110","Waldbronn",13151,6520,6631
"392","08215111","Dettenheim",6556,3313,3243
"393","08216","Rastatt, Landkreis",231018,114797,116221
"394","08216002","Au am Rhein",3336,1655,1681
"395","08216005","Bietigheim",6374,3179,3195
"396","08216006","Bischweier",2992,1515,1477
"397","08216007","Bühl, Stadt",28900,14173,14727
"398","08216008","Bühlertal",8105,4130,3975
"399","08216009","Durmersheim",12160,5993,6167
"400","08216012","Elchesheim-Illingen",3246,1628,1618
"401","08216013","Forbach",4736,2406,2330
"402","08216015","Gaggenau, Stadt",29777,14702,15075
"403","08216017","Gernsbach, Stadt",14296,7019,7277
"404","08216022","Hügelsheim",5115,2656,2459
"405","08216023","Iffezheim",5163,2585,2578
"406","08216024","Kuppenheim, Stadt",8330,4059,4271
"407","08216028","Lichtenau, Stadt",4975,2496,2479
"408","08216029","Loffenau",2523,1247,1276
"409","08216033","Muggensturm",6195,3057,3138
"410","08216039","Ötigheim",4884,2436,2448
"411","08216041","Ottersweier",6340,3206,3134
"412","08216043","Rastatt, Stadt",49783,24745,25038
"413","08216049","Sinzheim",11351,5583,5768
"414","08216052","Steinmauern",3089,1573,1516
"415","08216059","Weisenbach",2450,1244,1206
"416","08216063","Rheinmünster",6898,3510,3388
"417","08221000","Heidelberg, Stadtkreis",160355,77112,83243
"418","08222000","Mannheim, Stadtkreis",309370,154273,155097
"419","08225","Neckar-Odenwald-Kreis, Landkreis",143535,72057,71478
"420","08225001","Adelsheim, Stadt",4973,2617,2356
"421","08225002","Aglasterhausen",4902,2413,2489
"422","08225009","Billigheim",5903,3002,2901
"423","08225010","Binau",1426,744,682
"424","08225014","Buchen (Odenwald), Stadt",17796,8732,9064
"425","08225024","Fahrenbach",2766,1378,1388
"426","08225032","Hardheim",6682,3341,3341
"427","08225033","Haßmersheim",4986,2499,2487
"428","08225039","Höpfingen",2961,1472,1489
"429","08225042","Hüffenhardt",2091,1045,1046
"430","08225052","Limbach",4432,2241,2191
"431","08225058","Mosbach, Stadt",23398,11707,11691
"432","08225060","Mudau",4929,2534,2395
"433","08225064","Neckargerach",2308,1149,1159
"434","08225067","Neckarzimmern",1512,737,775
"435","08225068","Neunkirchen",1867,909,958
"436","08225074","Obrigheim",5307,2618,2689
"437","08225075","Osterburken, Stadt",6507,3278,3229
"438","08225082","Rosenberg",2076,1050,1026
"439","08225091","Seckach",4143,2126,2017
"440","08225109","Walldürn, Stadt",11518,5868,5650
"441","08225113","Zwingenberg",694,361,333
"442","08225114","Ravenstein, Stadt",2868,1493,1375
"443","08225115","Schefflenz",3922,1971,1951
"444","08225116","Schwarzach",2902,1517,1385
"445","08225117","Elztal",5861,2899,2962
"446","08225118","Waldbrunn",4805,2356,2449
"447","08226","Rhein-Neckar-Kreis, Landkreis",547625,269317,278308
"448","08226003","Altlußheim",6133,3051,3082
"449","08226006","Bammental",6561,3157,3404
"450","08226009","Brühl",14288,6823,7465
"451","08226010","Dielheim",9027,4515,4512
"452","08226012","Dossenheim",12515,6003,6512
"453","08226013","Eberbach, Stadt",14460,6939,7521
"454","08226017","Epfenbach",2427,1204,1223
"455","08226018","Eppelheim, Stadt",15177,7483,7694
"456","08226020","Eschelbronn",2704,1391,1313
"457","08226022","Gaiberg",2383,1161,1222
"458","08226027","Heddesbach",450,232,218
"459","08226028","Heddesheim",11569,5637,5932
"460","08226029","Heiligkreuzsteinach",2616,1291,1325
"461","08226031","Hemsbach, Stadt",11968,5906,6062
"462","08226032","Hockenheim, Stadt",21779,10880,10899
"463","08226036","Ilvesheim",9346,4558,4788
"464","08226037","Ketsch",12762,6167,6595
"465","08226038","Ladenburg, Stadt",11537,5567,5970
"466","08226040","Laudenbach",6355,3200,3155
"467","08226041","Leimen, Stadt",26968,13294,13674
"468","08226046","Malsch",3516,1751,1765
"469","08226048","Mauer",4006,1919,2087
"470","08226049","Meckesheim",5230,2623,2607
"471","08226054","Mühlhausen",8571,4318,4253
"472","08226055","Neckarbischofsheim, Stadt",4040,2045,1995
"473","08226056","Neckargemünd, Stadt",13290,6501,6789
"474","08226058","Neidenstein",1773,893,880
"475","08226059","Neulußheim",7127,3581,3546
"476","08226060","Nußloch",11325,5649,5676
"477","08226062","Oftersheim",12140,5931,6209
"478","08226063","Plankstadt",10321,5005,5316
"479","08226065","Rauenberg, Stadt",8693,4323,4370
"480","08226066","Reichartshausen",2079,1028,1051
"481","08226068","Reilingen",7630,3832,3798
"482","08226076","Sandhausen",15105,7387,7718
"483","08226080","Schönau, Stadt",4438,2210,2228
"484","08226081","Schönbrunn",2837,1398,1439
"485","08226082","Schriesheim, Stadt",15081,7318,7763
"486","08226084","Schwetzingen, Stadt",21433,10375,11058
"487","08226085","Sinsheim, Stadt",35442,17703,17739
"488","08226086","Spechbach",1699,832,867
"489","08226091","Waibstadt, Stadt",5682,2779,2903
"490","08226095","Walldorf, Stadt",15534,7692,7842
"491","08226096","Weinheim, Stadt",45284,22154,23130
"492","08226097","Wiesenbach",3119,1532,1587
"493","08226098","Wiesloch, Stadt",26758,13325,13433
"494","08226099","Wilhelmsfeld",3164,1539,1625
"495","08226101","Zuzenhausen",2217,1099,1118
"496","08226102","Angelbachtal",5111,2489,2622
"497","08226103","St. Leon-Rot",13734,6824,6910
"498","08226104","Lobbach",2359,1174,1185
"499","08226105","Edingen-Neckarhausen",14238,6936,7302
"500","08226106","Helmstadt-Bargen",3739,1887,1852
"501","08226107","Hirschberg an der Bergstraße",9885,4806,5079
"502","08231000","Pforzheim, Stadtkreis",125542,61699,63843
"503","08235","Calw, Landkreis",158397,79514,78883
"504","08235006","Altensteig, Stadt",10799,5452,5347
"505","08235007","Althengstett",7962,4033,3929
"506","08235008","Bad Liebenzell, Stadt",9573,4715,4858
"507","08235018","Dobel",2319,1144,1175
"508","08235020","Ebhausen",4772,2410,2362
"509","08235022","Egenhausen",2009,1012,997
"510","08235025","Enzklösterle",1249,645,604
"511","08235029","Gechingen",3658,1820,1838
"512","08235032","Haiterbach, Stadt",5761,2880,2881
"513","08235033","Bad Herrenalb, Stadt",7948,3890,4058
"514","08235035","Höfen an der Enz",1767,902,865
"515","08235046","Nagold, Stadt",22294,11145,11149
"516","08235047","Neubulach, Stadt",5624,2805,2819
"517","08235050","Neuweiler",3109,1606,1503
"518","08235055","Oberreichenbach",2831,1426,1405
"519","08235057","Ostelsheim",2437,1224,1213
"520","08235060","Rohrdorf",1957,991,966
"521","08235065","Schömberg",7991,3981,4010
"522","08235066","Simmersfeld",2101,1088,1013
"523","08235067","Simmozheim",2936,1461,1475
"524","08235073","Unterreichenbach",2417,1221,1196
"525","08235079","Bad Wildbad, Stadt",10130,5041,5089
"526","08235080","Wildberg, Stadt",10069,5090,4979
"527","08235084","Bad Teinach-Zavelstein, Stadt",3094,1600,1494
"528","08235085","Calw, Stadt",23590,11932,11658
"529","08236","Enzkreis, Landkreis",198905,98744,100161
"530","08236004","Birkenfeld",10238,5049,5189
"531","08236011","Eisingen",4741,2281,2460
"532","08236013","Engelsbrand",4416,2163,2253
"533","08236019","Friolzheim",4136,2085,2051
"534","08236025","Heimsheim, Stadt",5035,2690,2345
"535","08236028","Illingen",7727,3858,3869
"536","08236030","Ispringen",6041,2953,3088
"537","08236031","Kieselbronn",3010,1471,1539
"538","08236033","Knittlingen, Stadt",8048,3969,4079
"539","08236038","Maulbronn, Stadt",6588,3252,3336
"540","08236039","Mönsheim",2804,1428,1376
"541","08236040","Mühlacker, Stadt",26076,12951,13125
"542","08236043","Neuenbürg, Stadt",8206,4141,4065
"543","08236044","Neuhausen",5203,2544,2659
"544","08236046","Niefern-Öschelbronn",12089,5974,6115
"545","08236050","Ötisheim",4727,2386,2341
"546","08236061","Sternenfels",2867,1420,1447
"547","08236062","Tiefenbronn",5385,2710,2675
"548","08236065","Wiernsheim",6810,3439,3371
"549","08236067","Wimsheim",2837,1412,1425
"550","08236068","Wurmberg",3190,1613,1577
"551","08236070","Keltern",9167,4497,4670
"552","08236071","Remchingen",11806,5810,5996
"553","08236072","Straubenhardt",11203,5571,5632
"554","08236073","Neulingen",6703,3287,3416
"555","08236074","Kämpfelbach",6357,3156,3201
"556","08236075","Ölbronn-Dürrn",3444,1671,1773
"557","08236076","Königsbach-Stein",10051,4963,5088
"558","08237","Freudenstadt, Landkreis",117935,58898,59037
"559","08237002","Alpirsbach, Stadt",6304,3227,3077
"560","08237004","Baiersbronn",14592,7248,7344
"561","08237008","Betzweiler-Wälde",NA,NA,NA
"562","08237019","Dornstetten, Stadt",8061,3972,4089
"563","08237024","Empfingen",4038,2005,2033
"564","08237027","Eutingen im Gäu",5743,2900,2843
"565","08237028","Freudenstadt, Stadt",23442,11420,12022
"566","08237030","Glatten",2406,1225,1181
"567","08237032","Grömbach",633,321,312
"568","08237040","Horb am Neckar, Stadt",25135,12755,12380
"569","08237045","Loßburg",7442,3727,3715
"570","08237054","Pfalzgrafenweiler",7140,3557,3583
"571","08237061","Schopfloch",2569,1297,1272
"572","08237072","Wörnersberg",226,107,119
"573","08237073","Seewald",2134,1039,1095
"574","08237074","Waldachtal",6029,3067,2962
"575","08237075","Bad Rippoldsau-Schapbach",2041,1031,1010
"576","083","Freiburg, Regierungsbezirk",2264469,1116838,1147631
"577","08311000","Freiburg im Breisgau, Stadtkreis",230241,109829,120412
"578","08315","Breisgau-Hochschwarzwald, Landkreis",262795,129641,133154
"579","08315003","Au",1471,737,734
"580","08315004","Auggen",2815,1411,1404
"581","08315006","Bad Krozingen, Stadt",19644,9444,10200
"582","08315007","Badenweiler",4442,2161,2281
"583","08315008","Ballrechten-Dottingen",2407,1204,1203
"584","08315013","Bötzingen",5320,2639,2681
"585","08315014","Bollschweil",2307,1140,1167
"586","08315015","Breisach am Rhein, Stadt",15606,7745,7861
"587","08315016","Breitnau",1746,845,901
"588","08315020","Buchenbach",3118,1541,1577
"589","08315022","Buggingen",4338,2171,2167
"590","08315028","Ebringen",2879,1439,1440
"591","08315030","Eichstetten am Kaiserstuhl",3648,1833,1815
"592","08315031","Eisenbach (Hochschwarzwald)",2147,1100,1047
"593","08315033","Eschbach",2472,1231,1241
"594","08315037","Feldberg (Schwarzwald)",1897,996,901
"595","08315039","Friedenweiler",1994,1003,991
"596","08315041","Glottertal",3233,1646,1587
"597","08315043","Gottenheim",2884,1420,1464
"598","08315047","Gundelfingen",11674,5626,6048
"599","08315048","Hartheim am Rhein",4727,2389,2338
"600","08315050","Heitersheim, Stadt",6257,3128,3129
"601","08315051","Heuweiler",1106,560,546
"602","08315052","Hinterzarten",2583,1302,1281
"603","08315056","Horben",1178,559,619
"604","08315059","Ihringen",6088,2988,3100
"605","08315064","Kirchzarten",9740,4612,5128
"606","08315068","Lenzkirch",5048,2533,2515
"607","08315070","Löffingen, Stadt",7676,3864,3812
"608","08315072","Merdingen",2583,1241,1342
"609","08315073","Merzhausen",5280,2525,2755
"610","08315074","Müllheim, Stadt",19127,9280,9847
"611","08315076","Neuenburg am Rhein, Stadt",12437,6226,6211
"612","08315084","Oberried",2873,1466,1407
"613","08315089","Pfaffenweiler",2613,1296,1317
"614","08315094","St. Märgen",1861,933,928
"615","08315095","St. Peter",2625,1303,1322
"616","08315098","Schallstadt",6286,3079,3207
"617","08315102","Schluchsee",2518,1236,1282
"618","08315107","Sölden",1274,632,642
"619","08315108","Staufen im Breisgau, Stadt",8209,3888,4321
"620","08315109","Stegen",4469,2191,2278
"621","08315111","Sulzburg, Stadt",2771,1330,1441
"622","08315113","Titisee-Neustadt, Stadt",12269,6100,6169
"623","08315115","Umkirch",5793,2895,2898
"624","08315125","Wittnau",1528,777,751
"625","08315130","Münstertal/Schwarzwald",5110,2541,2569
"626","08315131","Ehrenkirchen",7379,3708,3671
"627","08315132","March",9314,4648,4666
"628","08315133","Vogtsburg im Kaiserstuhl, Stadt",6031,3079,2952
"629","08316","Emmendingen, Landkreis",165383,81772,83611
"630","08316002","Bahlingen am Kaiserstuhl",4236,2107,2129
"631","08316003","Biederbach",1782,931,851
"632","08316009","Denzlingen",13544,6592,6952
"633","08316010","Elzach, Stadt",7242,3588,3654
"634","08316011","Emmendingen, Stadt",27882,13502,14380
"635","08316012","Endingen am Kaiserstuhl, Stadt",9868,4907,4961
"636","08316013","Forchheim",1424,728,696
"637","08316014","Gutach im Breisgau",4479,2221,2258
"638","08316017","Herbolzheim, Stadt",11065,5522,5543
"639","08316020","Kenzingen, Stadt",10089,5029,5060
"640","08316024","Malterdingen",3296,1689,1607
"641","08316036","Reute",2896,1446,1450
"642","08316037","Riegel am Kaiserstuhl",3962,1978,1984
"643","08316038","Sasbach am Kaiserstuhl",3441,1761,1680
"644","08316039","Sexau",3353,1644,1709
"645","08316042","Simonswald",3048,1563,1485
"646","08316043","Teningen",12063,6047,6016
"647","08316045","Vörstetten",3031,1474,1557
"648","08316049","Weisweil",2124,1062,1062
"649","08316051","Wyhl am Kaiserstuhl",3869,1930,1939
"650","08316053","Rheinhausen",3845,1914,1931
"651","08316054","Freiamt",4163,2071,2092
"652","08316055","Winden im Elztal",2872,1452,1420
"653","08316056","Waldkirch, Stadt",21809,10614,11195
"654","08317","Ortenaukreis, Landkreis",429479,214221,215258
"655","08317001","Achern, Stadt",25630,12792,12838
"656","08317005","Appenweier",10256,5165,5091
"657","08317008","Bad Peterstal-Griesbach",2717,1387,1330
"658","08317009","Berghaupten",2394,1193,1201
"659","08317011","Biberach",3651,1840,1811
"660","08317021","Durbach",3893,1899,1994
"661","08317026","Ettenheim, Stadt",13316,6530,6786
"662","08317029","Fischerbach",1781,915,866
"663","08317031","Friesenheim",13089,6492,6597
"664","08317034","Gengenbach, Stadt",11023,5326,5697
"665","08317039","Gutach (Schwarzwaldbahn)",2294,1129,1165
"666","08317040","Haslach im Kinzigtal, Stadt",7114,3512,3602
"667","08317041","Hausach, Stadt",5768,2879,2889
"668","08317046","Hofstetten",1794,910,884
"669","08317047","Hohberg",8073,4039,4034
"670","08317051","Hornberg, Stadt",4318,2169,2149
"671","08317056","Kappelrodeck",6068,3072,2996
"672","08317057","Kehl, Stadt",36089,17967,18122
"673","08317059","Kippenheim",5545,2814,2731
"674","08317065","Lahr/Schwarzwald, Stadt",46797,23307,23490
"675","08317067","Lautenbach",1875,954,921
"676","08317068","Lauf",3929,1962,1967
"677","08317073","Mahlberg, Stadt",5061,2546,2515
"678","08317075","Meißenheim",4060,2037,2023
"679","08317078","Mühlenbach",1701,895,806
"680","08317085","Nordrach",1880,975,905
"681","08317088","Oberharmersbach",2501,1294,1207
"682","08317089","Oberkirch, Stadt",20066,10006,10060
"683","08317093","Oberwolfach",2633,1369,1264
"684","08317096","Offenburg, Stadt",59646,29207,30439
"685","08317097","Ohlsbach",3284,1638,1646
"686","08317098","Oppenau, Stadt",4718,2363,2355
"687","08317100","Ortenberg",3442,1724,1718
"688","08317102","Ottenhöfen im Schwarzwald",3179,1580,1599
"689","08317110","Renchen, Stadt",7361,3689,3672
"690","08317113","Ringsheim",2384,1216,1168
"691","08317114","Rust",4285,2192,2093
"692","08317116","Sasbach",5340,2651,2689
"693","08317118","Sasbachwalden",2546,1277,1269
"694","08317121","Schuttertal",3200,1639,1561
"695","08317122","Schutterwald",7215,3661,3554
"696","08317126","Seebach",1426,749,677
"697","08317127","Seelbach",4878,2376,2502
"698","08317129","Steinach",4005,2031,1974
"699","08317141","Willstätt",9985,4998,4987
"700","08317145","Wolfach, Stadt",5850,2953,2897
"701","08317146","Zell am Harmersbach, Stadt",8112,4012,4100
"702","08317150","Schwanau",7080,3632,3448
"703","08317151","Neuried",9736,4842,4894
"704","08317152","Kappel-Grafenhausen",5096,2651,2445
"705","08317153","Rheinau, Stadt",11395,5765,5630
"706","08317971","Rheinau, gemeindefreies Gebiet",NA,NA,NA
"707","08325","Rottweil, Landkreis",139455,69767,69688
"708","08325001","Aichhalden",4141,2043,2098
"709","08325009","Bösingen",3321,1681,1640
"710","08325011","Dietingen",4012,2016,1996
"711","08325012","Dornhan, Stadt",6006,3024,2982
"712","08325014","Dunningen",6305,3207,3098
"713","08325015","Epfendorf",3318,1708,1610
"714","08325024","Hardt",2532,1274,1258
"715","08325036","Lauterbach",2918,1482,1436
"716","08325045","Oberndorf am Neckar, Stadt",14073,7016,7057
"717","08325049","Rottweil, Stadt",25274,12434,12840
"718","08325050","Schenkenzell",1799,932,867
"719","08325051","Schiltach, Stadt",3809,1869,1940
"720","08325053","Schramberg, Stadt",21189,10647,10542
"721","08325057","Sulz am Neckar, Stadt",12336,6173,6163
"722","08325058","Tennenbronn",NA,NA,NA
"723","08325060","Villingendorf",3347,1676,1671
"724","08325061","Vöhringen",4335,2175,2160
"725","08325064","Wellendingen",3202,1605,1597
"726","08325069","Zimmern ob Rottweil",6228,3104,3124
"727","08325070","Fluorn-Winzeln",3100,1589,1511
"728","08325071","Eschbronn",2073,1038,1035
"729","08325072","Deißlingen",6137,3074,3063
"730","08326","Schwarzwald-Baar-Kreis, Landkreis",212381,105542,106839
"731","08326003","Bad Dürrheim, Stadt",13260,6451,6809
"732","08326005","Blumberg, Stadt",10127,5106,5021
"733","08326006","Bräunlingen, Stadt",5828,2933,2895
"734","08326010","Dauchingen",3767,1857,1910
"735","08326012","Donaueschingen, Stadt",22526,11371,11155
"736","08326017","Furtwangen im Schwarzwald, Stadt",9091,4755,4336
"737","08326020","Gütenbach",1137,590,547
"738","08326027","Hüfingen, Stadt",7799,3892,3907
"739","08326031","Königsfeld im Schwarzwald",6027,2903,3124
"740","08326037","Mönchweiler",2977,1475,1502
"741","08326041","Niedereschach",5917,2976,2941
"742","08326052","St. Georgen im Schwarzwald, Stadt",12958,6412,6546
"743","08326054","Schönwald im Schwarzwald",2444,1230,1214
"744","08326055","Schonach im Schwarzwald",4045,2033,2012
"745","08326060","Triberg im Schwarzwald, Stadt",4794,2410,2384
"746","08326061","Tuningen",2931,1469,1462
"747","08326065","Unterkirnach",2582,1357,1225
"748","08326068","Vöhrenbach, Stadt",3853,1956,1897
"749","08326074","Villingen-Schwenningen, Stadt",85181,41843,43338
"750","08326075","Brigachtal",5137,2523,2614
"751","08327","Tuttlingen, Landkreis",140152,70452,69700
"752","08327002","Aldingen",7555,3841,3714
"753","08327004","Bärenthal",484,250,234
"754","08327005","Balgheim",1248,638,610
"755","08327006","Böttingen",1422,722,700
"756","08327007","Bubsheim",1376,750,626
"757","08327008","Buchheim",683,342,341
"758","08327009","Deilingen",1738,904,834
"759","08327010","Denkingen",2657,1345,1312
"760","08327011","Dürbheim",1681,833,848
"761","08327012","Durchhausen",984,505,479
"762","08327013","Egesheim",631,327,304
"763","08327016","Fridingen an der Donau, Stadt",3174,1590,1584
"764","08327017","Frittlingen",2190,1137,1053
"765","08327018","Geisingen, Stadt",6202,3171,3031
"766","08327019","Gosheim",3880,1948,1932
"767","08327020","Gunningen",737,377,360
"768","08327023","Hausen ob Verena",776,396,380
"769","08327025","Immendingen",6259,3109,3150
"770","08327027","Irndorf",693,345,348
"771","08327029","Königsheim",579,302,277
"772","08327030","Kolbingen",1251,620,631
"773","08327033","Mahlstetten",813,418,395
"774","08327036","Mühlheim an der Donau, Stadt",3607,1797,1810
"775","08327038","Neuhausen ob Eck",3808,1897,1911
"776","08327040","Reichenbach am Heuberg",515,256,259
"777","08327041","Renquishausen",753,389,364
"778","08327046","Spaichingen, Stadt",13084,6514,6570
"779","08327048","Talheim",1224,635,589
"780","08327049","Trossingen, Stadt",16829,8481,8348
"781","08327050","Tuttlingen, Stadt",35730,17802,17928
"782","08327051","Wehingen",3680,1845,1835
"783","08327054","Wurmlingen",3812,1874,1938
"784","08327055","Seitingen-Oberflacht",2559,1295,1264
"785","08327056","Rietheim-Weilheim",2824,1427,1397
"786","08327057","Emmingen-Liptingen",4714,2370,2344
"787","08335","Konstanz, Landkreis",285325,139046,146279
"788","08335001","Aach, Stadt",2296,1178,1118
"789","08335002","Allensbach",7087,3339,3748
"790","08335015","Büsingen am Hochrhein",1491,736,755
"791","08335021","Eigeltingen",3843,1927,1916
"792","08335022","Engen, Stadt",10796,5390,5406
"793","08335025","Gaienhofen",3480,1697,1783
"794","08335026","Gailingen am Hochrhein",2852,1394,1458
"795","08335028","Gottmadingen",10656,5208,5448
"796","08335035","Hilzingen",8754,4300,4454
"797","08335043","Konstanz, Universitätsstadt",84760,40722,44038
"798","08335055","Moos",3243,1606,1637
"799","08335057","Mühlingen",2482,1264,1218
"800","08335061","Öhningen",3671,1793,1878
"801","08335063","Radolfzell am Bodensee, Stadt",31203,15103,16100
"802","08335066","Reichenau",5307,2738,2569
"803","08335075","Singen (Hohentwiel), Stadt",47723,23162,24561
"804","08335077","Steißlingen",4838,2391,2447
"805","08335079","Stockach, Stadt",17114,8439,8675
"806","08335080","Tengen, Stadt",4584,2290,2294
"807","08335081","Volkertshausen",3114,1531,1583
"808","08335096","Hohenfels",2038,1031,1007
"809","08335097","Mühlhausen-Ehingen",3873,1958,1915
"810","08335098","Bodman-Ludwigshafen",4655,2229,2426
"811","08335099","Orsingen-Nenzingen",3519,1758,1761
"812","08335100","Rielasingen-Worblingen",11946,5862,6084
"813","08336","Lörrach, Landkreis",228639,111981,116658
"814","08336004","Aitern",534,275,259
"815","08336006","Bad Bellingen",4480,2250,2230
"816","08336008","Binzen",3046,1472,1574
"817","08336010","Böllen",100,51,49
"818","08336012","Bürchau",NA,NA,NA
"819","08336014","Efringen-Kirchen",8642,4319,4323
"820","08336019","Eimeldingen",2558,1258,1300
"821","08336020","Elbenschwand",NA,NA,NA
"822","08336024","Fischingen",791,398,393
"823","08336025","Fröhnd",477,239,238
"824","08336034","Hasel",1108,554,554
"825","08336036","Hausen im Wiesental",2393,1181,1212
"826","08336043","Inzlingen",2508,1235,1273
"827","08336045","Kandern, Stadt",8249,4048,4201
"828","08336050","Lörrach, Stadt",49347,23844,25503
"829","08336057","Maulburg",4222,2107,2115
"830","08336060","Neuenweg",NA,NA,NA
"831","08336067","Raich",NA,NA,NA
"832","08336069","Rheinfelden (Baden), Stadt",33074,16251,16823
"833","08336073","Rümmingen",1870,932,938
"834","08336074","Sallneck",NA,NA,NA
"835","08336075","Schallbach",787,391,396
"836","08336078","Schliengen",5651,2763,2888
"837","08336079","Schönau im Schwarzwald, Stadt",2420,1182,1238
"838","08336080","Schönenberg",345,172,173
"839","08336081","Schopfheim, Stadt",19645,9573,10072
"840","08336082","Schwörstadt",2518,1242,1276
"841","08336084","Steinen",10049,4920,5129
"842","08336086","Tegernau",NA,NA,NA
"843","08336087","Todtnau, Stadt",4894,2434,2460
"844","08336089","Tunau",189,98,91
"845","08336090","Utzenfeld",622,312,310
"846","08336091","Weil am Rhein, Stadt",30175,14645,15530
"847","08336094","Wembach",337,167,170
"848","08336096","Wieden",541,277,264
"849","08336097","Wies",NA,NA,NA
"850","08336098","Wieslet",NA,NA,NA
"851","08336100","Wittlingen",942,475,467
"852","08336103","Zell im Wiesental, Stadt",6325,3147,3178
"853","08336104","Malsburg-Marzell",1499,757,742
"854","08336105","Grenzach-Wyhlen",14581,7114,7467
"855","08336106","Häg-Ehrsberg",851,435,416
"856","08336107","Kleines Wiesental",2869,1463,1406
"857","08337","Waldshut, Landkreis",170619,84587,86032
"858","08337002","Albbruck",7335,3686,3649
"859","08337013","Bernau im Schwarzwald",1982,1017,965
"860","08337022","Bonndorf im Schwarzwald, Stadt",6922,3529,3393
"861","08337027","Dachsberg (Südschwarzwald)",1421,694,727
"862","08337030","Dettighofen",1139,584,555
"863","08337032","Dogern",2333,1163,1170
"864","08337038","Görwihl",4273,2130,2143
"865","08337039","Grafenhausen",2235,1136,1099
"866","08337045","Häusern",1316,661,655
"867","08337049","Herrischried",2755,1384,1371
"868","08337051","Höchenschwand",2669,1334,1335
"869","08337053","Hohentengen am Hochrhein",3898,2009,1889
"870","08337059","Ibach",354,160,194
"871","08337060","Jestetten",5276,2560,2716
"872","08337062","Klettgau",7569,3819,3750
"873","08337065","Lauchringen",7724,3759,3965
"874","08337066","Laufenburg (Baden), Stadt",9029,4429,4600
"875","08337070","Lottstetten",2238,1125,1113
"876","08337076","Murg",7041,3499,3542
"877","08337090","Rickenbach",3983,2003,1980
"878","08337096","Bad Säckingen, Stadt",17144,8252,8892
"879","08337097","St. Blasien, Stadt",4009,1971,2038
"880","08337106","Stühlingen, Stadt",5327,2718,2609
"881","08337108","Todtmoos",1963,974,989
"882","08337116","Wehr, Stadt",13098,6414,6684
"883","08337118","Weilheim",3146,1591,1555
"884","08337123","Wutöschingen",6612,3301,3311
"885","08337124","Eggingen",1704,852,852
"886","08337125","Küssaberg",5399,2652,2747
"887","08337126","Waldshut-Tiengen, Stadt",24226,11919,12307
"888","08337127","Wutach",1213,600,613
"889","08337128","Ühlingen-Birkendorf",5286,2662,2624
"890","084","Tübingen, Regierungsbezirk",1856517,923140,933377
"891","08415","Reutlingen, Landkreis",286748,142232,144516
"892","08415014","Dettingen an der Erms",9712,4795,4917
"893","08415019","Eningen unter Achalm",11199,5552,5647
"894","08415027","Gomadingen",2246,1178,1068
"895","08415028","Grabenstetten",1642,840,802
"896","08415029","Grafenberg",2676,1342,1334
"897","08415034","Hayingen, Stadt",2203,1121,1082
"898","08415039","Hülben",2916,1454,1462
"899","08415048","Mehrstetten",1424,732,692
"900","08415050","Metzingen, Stadt",22046,10896,11150
"901","08415053","Münsingen, Stadt",14335,7044,7291
"902","08415058","Pfronstetten",1514,797,717
"903","08415059","Pfullingen, Stadt",18654,9059,9595
"904","08415060","Pliezhausen",9721,4804,4917
"905","08415061","Reutlingen, Stadt",115966,57332,58634
"906","08415062","Riederich",4377,2143,2234
"907","08415073","Trochtelfingen, Stadt",6366,3223,3143
"908","08415078","Bad Urach, Stadt",12472,6208,6264
"909","08415080","Wannweil",5295,2615,2680
"910","08415085","Zwiefalten",2201,1151,1050
"911","08415086","Gutsbezirk Münsingen",NA,NA,NA
"912","08415087","Walddorfhäslach",5227,2601,2626
"913","08415088","Römerstein",3991,2005,1986
"914","08415089","Engstingen",5289,2655,2634
"915","08415090","Hohenstein",3719,1875,1844
"916","08415091","Sonnenbühl",7157,3622,3535
"917","08415092","Lichtenstein",9239,4593,4646
"918","08415093","St. Johann",5161,2595,2566
"919","08415971","Gutsbezirk Münsingen, gemeindefreies Gebiet",NA,NA,NA
"920","08416","Tübingen, Landkreis",227331,110795,116536
"921","08416006","Bodelshausen",5811,2906,2905
"922","08416009","Dettenhausen",5431,2661,2770
"923","08416011","Dußlingen",6225,3078,3147
"924","08416015","Gomaringen",9001,4422,4579
"925","08416018","Hirrlingen",3093,1571,1522
"926","08416022","Kirchentellinsfurt",5611,2766,2845
"927","08416023","Kusterdingen",8597,4322,4275
"928","08416025","Mössingen, Stadt",20480,9987,10493
"929","08416026","Nehren",4343,2154,2189
"930","08416031","Ofterdingen",5088,2540,2548
"931","08416036","Rottenburg am Neckar, Stadt",43723,21718,22005
"932","08416041","Tübingen, Universitätsstadt",90546,43020,47526
"933","08416048","Ammerbuch",11331,5622,5709
"934","08416049","Neustetten",3688,1851,1837
"935","08416050","Starzach",4363,2177,2186
"936","08417","Zollernalbkreis, Landkreis",188935,93808,95127
"937","08417002","Balingen, Stadt",34217,16711,17506
"938","08417008","Bisingen",9423,4652,4771
"939","08417010","Bitz",3638,1758,1880
"940","08417013","Burladingen, Stadt",12146,5973,6173
"941","08417014","Dautmergen",427,225,202
"942","08417015","Dormettingen",1128,571,557
"943","08417016","Dotternhausen",1871,949,922
"944","08417022","Geislingen, Stadt",5881,2967,2914
"945","08417023","Grosselfingen",2221,1101,1120
"946","08417025","Haigerloch, Stadt",10669,5363,5306
"947","08417029","Hausen am Tann",467,245,222
"948","08417031","Hechingen, Stadt",19324,9551,9773
"949","08417036","Jungingen",1346,648,698
"950","08417044","Meßstetten, Stadt",10653,5487,5166
"951","08417045","Nusplingen",1838,923,915
"952","08417047","Obernheim",1458,745,713
"953","08417051","Rangendingen",5255,2579,2676
"954","08417052","Ratshausen",762,393,369
"955","08417054","Rosenfeld, Stadt",6347,3225,3122
"956","08417057","Schömberg, Stadt",4627,2357,2270
"957","08417063","Straßberg",2477,1228,1249
"958","08417071","Weilen unter den Rinnen",613,324,289
"959","08417075","Winterlingen",6351,3111,3240
"960","08417078","Zimmern unter der Burg",469,248,221
"961","08417079","Albstadt, Stadt",45327,22474,22853
"962","08421000","Ulm, Stadtkreis",126329,62660,63669
"963","08425","Alb-Donau-Kreis, Landkreis",196047,99041,97006
"964","08425002","Allmendingen",4439,2207,2232
"965","08425004","Altheim",625,339,286
"966","08425005","Altheim (Alb)",1707,864,843
"967","08425008","Amstetten",4013,2022,1991
"968","08425011","Asselfingen",1028,539,489
"969","08425013","Ballendorf",646,305,341
"970","08425014","Beimerstetten",2511,1253,1258
"971","08425017","Berghülen",1932,981,951
"972","08425019","Bernstadt",2257,1168,1089
"973","08425020","Blaubeuren, Stadt",12521,6360,6161
"974","08425022","Börslingen",164,83,81
"975","08425024","Breitingen",332,162,170
"976","08425028","Dietenheim, Stadt",6715,3356,3359
"977","08425031","Dornstadt",8686,4359,4327
"978","08425033","Ehingen (Donau), Stadt",26259,13352,12907
"979","08425035","Emeringen",144,76,68
"980","08425036","Emerkingen",848,443,405
"981","08425039","Erbach, Stadt",13453,6779,6674
"982","08425050","Griesingen",1039,526,513
"983","08425052","Grundsheim",221,103,118
"984","08425055","Hausen am Bussen",248,122,126
"985","08425062","Holzkirch",275,130,145
"986","08425064","Hüttisheim",1464,710,754
"987","08425066","Illerrieden",3323,1667,1656
"988","08425071","Laichingen, Stadt",11731,5985,5746
"989","08425072","Langenau, Stadt",15247,7663,7584
"990","08425073","Lauterach",569,285,284
"991","08425075","Lonsee",4993,2572,2421
"992","08425079","Merklingen",1996,1002,994
"993","08425081","Munderkingen, Stadt",5292,2634,2658
"994","08425083","Neenstetten",835,419,416
"995","08425084","Nellingen",2044,1066,978
"996","08425085","Nerenstetten",339,168,171
"997","08425088","Oberdischingen",2129,1038,1091
"998","08425090","Obermarchtal",1288,653,635
"999","08425091","Oberstadion",1565,807,758
"1000","08425092","Öllingen",537,276,261
"1001","08425093","Öpfingen",2355,1188,1167
"1002","08425097","Rammingen",1307,691,616
"1003","08425098","Rechtenstein",306,163,143
"1004","08425104","Rottenacker",2194,1151,1043
"1005","08425108","Schelklingen, Stadt",6883,3554,3329
"1006","08425110","Schnürpflingen",1385,691,694
"1007","08425112","Setzingen",693,362,331
"1008","08425123","Untermarchtal",893,355,538
"1009","08425124","Unterstadion",772,390,382
"1010","08425125","Unterwachingen",200,103,97
"1011","08425130","Weidenstetten",1370,719,651
"1012","08425134","Westerheim",3029,1511,1518
"1013","08425135","Westerstetten",2190,1077,1113
"1014","08425137","Illerkirchberg",4826,2441,2385
"1015","08425138","Staig",3155,1581,1574
"1016","08425139","Heroldstatt",2857,1417,1440
"1017","08425140","Balzheim",2056,1056,1000
"1018","08425141","Blaustein, Stadt",16161,8117,8044
"1019","08426","Biberach, Landkreis",199742,100634,99108
"1020","08426001","Achstetten",4920,2473,2447
"1021","08426005","Alleshausen",524,270,254
"1022","08426006","Allmannsweiler",304,162,142
"1023","08426008","Altheim",2111,1060,1051
"1024","08426011","Attenweiler",1934,1026,908
"1025","08426013","Bad Buchau, Stadt",4294,2163,2131
"1026","08426014","Bad Schussenried, Stadt",8734,4429,4305
"1027","08426019","Berkheim",2921,1499,1422
"1028","08426020","Betzenweiler",770,386,384
"1029","08426021","Biberach an der Riß, Stadt",32938,16183,16755
"1030","08426028","Burgrieden",4072,2064,2008
"1031","08426031","Dettingen an der Iller",2439,1225,1214
"1032","08426035","Dürmentingen",2576,1327,1249
"1033","08426036","Dürnau",453,234,219
"1034","08426038","Eberhardzell",4511,2342,2169
"1035","08426043","Erlenmoos",1794,906,888
"1036","08426044","Erolzheim",3342,1700,1642
"1037","08426045","Ertingen",5413,2757,2656
"1038","08426058","Hochdorf",2327,1186,1141
"1039","08426062","Ingoldingen",2969,1531,1438
"1040","08426064","Kanzach",486,234,252
"1041","08426065","Kirchberg an der Iller",2087,1052,1035
"1042","08426066","Kirchdorf an der Iller",3757,1911,1846
"1043","08426067","Langenenslingen",3526,1784,1742
"1044","08426070","Laupheim, Stadt",22298,11126,11172
"1045","08426071","Maselheim",4576,2350,2226
"1046","08426073","Mietingen",4375,2239,2136
"1047","08426074","Mittelbiberach",4403,2167,2236
"1048","08426078","Moosburg",208,101,107
"1049","08426087","Ochsenhausen, Stadt",8856,4509,4347
"1050","08426090","Oggelshausen",956,479,477
"1051","08426097","Riedlingen, Stadt",10528,5329,5199
"1052","08426100","Rot an der Rot",4565,2339,2226
"1053","08426108","Schwendi",6726,3459,3267
"1054","08426109","Seekirch",296,154,142
"1055","08426113","Steinhausen an der Rottum",2141,1099,1042
"1056","08426117","Tannheim",2497,1283,1214
"1057","08426118","Tiefenbach",519,256,263
"1058","08426120","Ummendorf",4327,2159,2168
"1059","08426121","Unlingen",2448,1228,1220
"1060","08426124","Uttenweiler",3590,1824,1766
"1061","08426125","Wain",1646,849,797
"1062","08426128","Warthausen",5318,2627,2691
"1063","08426134","Schemmerhofen",8412,4236,4176
"1064","08426135","Gutenzell-Hürbel",1855,917,938
"1065","08435","Bodenseekreis, Landkreis",216227,106544,109683
"1066","08435005","Bermatingen",4027,1999,2028
"1067","08435010","Daisendorf",1597,786,811
"1068","08435013","Eriskirch",4908,2444,2464
"1069","08435015","Frickingen",2981,1500,1481
"1070","08435016","Friedrichshafen, Stadt",60865,30236,30629
"1071","08435018","Hagnau am Bodensee",1409,685,724
"1072","08435020","Heiligenberg",3042,1532,1510
"1073","08435024","Immenstaad am Bodensee",6532,3244,3288
"1074","08435029","Kressbronn am Bodensee",8720,4349,4371
"1075","08435030","Langenargen",7721,3724,3997
"1076","08435034","Markdorf, Stadt",14031,6949,7082
"1077","08435035","Meckenbeuren",13520,6782,6738
"1078","08435036","Meersburg, Stadt",5944,2834,3110
"1079","08435042","Neukirch",2704,1380,1324
"1080","08435045","Oberteuringen",4979,2500,2479
"1081","08435047","Owingen",4351,2148,2203
"1082","08435052","Salem",11345,5577,5768
"1083","08435053","Sipplingen",2095,1025,1070
"1084","08435054","Stetten",1043,494,549
"1085","08435057","Tettnang, Stadt",19198,9565,9633
"1086","08435059","Überlingen, Stadt",22554,10519,12035
"1087","08435066","Uhldingen-Mühlhofen",8305,4026,4279
"1088","08435067","Deggenhausertal",4356,2246,2110
"1089","08436","Ravensburg, Landkreis",284285,141777,142508
"1090","08436001","Achberg",1743,879,864
"1091","08436003","Aichstetten",2806,1465,1341
"1092","08436004","Aitrach",2726,1422,1304
"1093","08436005","Altshausen",4131,2135,1996
"1094","08436006","Amtzell",4213,2109,2104
"1095","08436008","Aulendorf, Stadt",10180,5149,5031
"1096","08436009","Bad Waldsee, Stadt",20308,9945,10363
"1097","08436010","Bad Wurzach, Stadt",14651,7501,7150
"1098","08436011","Baienfurt",7247,3610,3637
"1099","08436012","Baindt",5223,2588,2635
"1100","08436013","Berg",4435,2236,2199
"1101","08436014","Bergatreute",3138,1618,1520
"1102","08436018","Bodnegg",3213,1647,1566
"1103","08436019","Boms",664,338,326
"1104","08436024","Ebenweiler",1213,630,583
"1105","08436027","Eichstegen",506,254,252
"1106","08436032","Fleischwangen",702,364,338
"1107","08436039","Grünkraut",3218,1628,1590
"1108","08436040","Guggenhausen",189,88,101
"1109","08436047","Hoßkirch",748,383,365
"1110","08436049","Isny im Allgäu, Stadt",14018,7011,7007
"1111","08436052","Kißlegg",9043,4522,4521
"1112","08436053","Königseggwald",675,346,329
"1113","08436055","Leutkirch im Allgäu, Stadt",22803,11470,11333
"1114","08436064","Ravensburg, Stadt",50623,25047,25576
"1115","08436067","Riedhausen",679,343,336
"1116","08436069","Schlier",3882,1956,1926
"1117","08436077","Unterwaldhausen",293,146,147
"1118","08436078","Vogt",4576,2322,2254
"1119","08436079","Waldburg",3142,1567,1575
"1120","08436081","Wangen im Allgäu, Stadt",26905,13131,13774
"1121","08436082","Weingarten, Stadt",24943,11966,12977
"1122","08436083","Wilhelmsdorf",5103,2576,2527
"1123","08436085","Wolfegg",3776,1879,1897
"1124","08436087","Wolpertswende",4176,2118,2058
"1125","08436093","Ebersbach-Musbach",1699,871,828
"1126","08436094","Argenbühl",6527,3314,3213
"1127","08436095","Horgenzell",5419,2802,2617
"1128","08436096","Fronreute",4749,2401,2348
"1129","08437","Sigmaringen, Landkreis",130873,65649,65224
"1130","08437005","Beuron",650,360,290
"1131","08437008","Bingen",2703,1364,1339
"1132","08437031","Gammertingen, Stadt",6320,3242,3078
"1133","08437044","Herbertingen",4792,2449,2343
"1134","08437047","Hettingen, Stadt",1783,911,872
"1135","08437053","Hohentengen",4155,2109,2046
"1136","08437056","Illmensee",2029,1009,1020
"1137","08437059","Inzigkofen",2795,1400,1395
"1138","08437065","Krauchenwies",5007,2528,2479
"1139","08437072","Leibertingen",2118,1071,1047
"1140","08437076","Mengen, Stadt",9896,4983,4913
"1141","08437078","Meßkirch, Stadt",8418,4276,4142
"1142","08437082","Neufra",1852,920,932
"1143","08437086","Ostrach",6757,3415,3342
"1144","08437088","Pfullendorf, Stadt",13437,6671,6766
"1145","08437100","Bad Saulgau, Stadt",17509,8569,8940
"1146","08437101","Scheer, Stadt",2490,1269,1221
"1147","08437102","Schwenningen",1658,837,821
"1148","08437104","Sigmaringen, Stadt",17278,8686,8592
"1149","08437105","Sigmaringendorf",3643,1843,1800
"1150","08437107","Stetten am kalten Markt",4788,2418,2370
"1151","08437114","Veringenstadt, Stadt",2168,1079,1089
"1152","08437118","Wald",2680,1254,1426
"1153","08437123","Sauldorf",2505,1279,1226
"1154","08437124","Herdwangen-Schönach",3442,1707,1735
"1155","__________",NA,NA,NA,NA
